 █████ █████████████ █████ █    
█.....█.............█.....█...█ 
█.███.███. ███████ .█.███.█.█.█.
█...█.█...█.......█...█...█.█.@.
█.█.█.█.   ████.███████.███. ███
█.█.█.█...█.....█.....█.█...█   
 ██.█.█ █.█.█████.███.█.███.    
█...█.█ █.█...█.....█.......█   
█. ██.███.█.█.█.██████████      
█.█.....█.█.█...█.........█     
█.█████.█.█.█████.███████.██    
█...█.....█.█.....█.....█...█   
█.█.███████.█.█████████.███.█   
█.█.█.....█.█.█...........█.█   
█.█.█.███.███.█.███.█████.█.█   
█.█.....█.█...█...█.█.....█.█   
█.███████.█.██ ██.█.█████.█.██  
█.█.......█...█...█.....█.█...█ 
█.█.█████.██ .███.████ .█.███.█ 
█.█...█.█.█.█...█.█...█. .█...█ 
 ████.█.█.█.██ .███. ██.███.██  
█.....█.█.....█.....█.█...█.█   
█.█████.█████.███████.█.█.█.█   
█...█.█.....█.█.....█...█...█   
 ██.█.█.███.█.█.███.█.██████    
█...█.█.█.█...█.█...█.....█     
█.███.█.█.███████.█.█████.█     
█.█...█...........█.█.....█     
█.███.█████████████.█.████      
█...█.....█.......█.█.█         
█.█.█.█.███.█.███.█.█.████      
█.█.█*█...█.█.█...█.█.....█     
█.█.███.█.█.█.█████.█████.█     
█.█...█.█...█.█.....█.....█     
█.███.█████.█.█.█████.████      
█.█.█.....█.█.....█.█...█       
█.█.█████.███████.█.███.█       
█.█.....█.....█.....█...█       
█.█████.█████.███████.██        
█...........█.........█         
 ███████████ █████████          

